3100130303
0030000130
3000000003
3020002300
3000100030
3313033023