03000030
00000000
00010000
00002000
00000000
03000040