01000010
00000000
00050000
00000000
02000020
00000000