01010010
00000000
00000040
00202000
03033000
00000030