10004000
00020000
00000050
02002000
00030300
03000001